1111111111111
10P100C0000C1
10C0011110C01
10001100C00E1
1111111111111
