1111111111111
100100C0000C1
10C0011110C01
1P001100C00E1
1111111111111
