1111111111111111111111
10C0000C000000C00000E1
1C000C001110C00000C001
10C01100C001111100C001
1C000011100C000C000001
1000C00000C000000C00P1
1111111111111111111111
