1111111111111111111111
1000C000000000000000E1
100C00000111000000C001
1000110000011111000001
1C0000111000000C000001
1000C000000000000C00P1
1111111111111111111111
