1111111111
1C00X00001
1000P00001
1000000E01
1111111111
