111111111111
1C000000E001
1P1000000001
100E00000001
111111111111
