111111111111
1C000000C001
10C000000C01
10C0000P0001
111111111111
